! If you're looking for settings to configure, they won't be saved here until
! you change something in the fluxbox configuration menu.

session.menuFile:	~/.@pkgprefix@fluxbox@pkgsuffix@/menu
session.keyFile: ~/.@pkgprefix@fluxbox@pkgsuffix@/keys
session.configVersion:	13
!session.styleFile: @default_style@
session.styleFile:	/usr/share/fluxbox/styles/peak_patina


session.appsFile:	~/.fluxbox/apps
session.autoRaiseDelay:	250
session.cacheLife:	5
session.cacheMax:	200
session.colorsPerChannel:	4
session.doubleClickInterval:	250
session.focusTabMinWidth:	0
session.forcePseudoTransparency:	true
session.groupFile:
session.iconbar:	true
session.ignoreBorder:	false
session.imageDither:	True
session.keyFile:	~/.fluxbox/keys
session.menuFile:	~/.fluxbox/menu
session.menuSearch:	itemstart
session.modKey:	Mod1
session.numLayers:	13
session.opaqueMove:	false
session.screen0.allowRemoteActions:	true
session.screen0.antialias:	true
session.screen0.autoRaise:	false
session.screen0.clickRaises:	true
session.screen0.clientMenu.usePixmap:	true
session.screen0.colPlacementDirection:	TopToBottom
session.screen0.decorateTransient:	false
session.screen0.defaultDeco:	NORMAL
session.screen0.demandsAttentionTimeout:	500
session.screen0.edgeResizeSnapThreshold:	0
session.screen0.edgeSnapThreshold:	8
session.screen0.focusLastWindow:	true
session.screen0.focusModel:	ClickFocus
session.screen0.focusNewWindows:	true
session.screen0.focusSameHead:	false
session.screen0.followModel:	Ignore
session.screen0.fullMaximization:	false
session.screen0.iconbar.alignment:	Relative
session.screen0.iconbar.deiconifyMode:	Follow
session.screen0.iconbar.iconifiedPattern: %t
session.screen0.iconbar.iconTextPadding:	10
session.screen0.iconbar.iconWidth:	70
session.screen0.iconbar.mode:	{static groups} (workspace)
session.screen0.iconbar.usePixmap:	true
session.screen0.imageDither:	false
session.screen0.maxDisableMove:	false
session.screen0.maxDisableResize:	false
session.screen0.maxIgnoreIncrement:	false
session.screen0.menu.alpha:	180
session.screen0.menuAlpha:	180
session.screen0.menuDelay:	0
session.screen0.menuDelayClose:	0
session.screen0.menuMode:	Delay
session.screen0.noFocusWhileTypingDelay:	0
session.screen0.opaqueMove:	false
session.screen0.overlay.capStyle:	CapNotLast
session.screen0.overlay.joinStyle:	JoinMiter
session.screen0.overlay.lineStyle:	LineSolid
session.screen0.overlay.lineWidth:	1
session.screen0.resizeMode:	Bottom
session.screen0.rootCommand:
session.screen0.rowPlacementDirection:	LeftToRight
session.screen0.showwindowposition:	true
session.screen0.slit.acceptKdeDockapps:	true
session.screen0.slit.alpha:	255
session.screen0.slit.autoHide:	false
session.screen0.slit.autoRaise:	false
session.screen0.slit.direction:	Vertical
session.screen0.slit.layer:	Desktop
session.screen0.slit.maxOver:	true
session.screen0.slit.onTop:	false
session.screen0.slit.onhead:	0
session.screen0.slit.placement:	TopRight
session.screen0.sloppywindowgrouping:	true
session.screen0.strftimeFormat:	%a %d %b   %k:%M
session.screen0.tab.alignment:	Left
session.screen0.tab.height:	20
session.screen0.tab.placement:	Top
session.screen0.tab.rotatevertical:	True
session.screen0.tab.width:	64
session.screen0.tabFocusModel:	ClickToTabFocus
session.screen0.tabs.intitlebar:	true
session.screen0.tabs.maxOver:	false
session.screen0.tabs.usePixmap:	false
session.screen0.titlebar.left:	Stick
session.screen0.titlebar.right:	Minimize Maximize Close
session.screen0.toolbar.alpha:	180
session.screen0.toolbar.autoHide:	false
session.screen0.toolbar.autoRaise:	false
session.screen0.toolbar.button.homenu.commands: RootMenu
session.screen0.toolbar.button.homenu.font: sans-8
session.screen0.toolbar.button.homenu.label: Menu
session.screen0.toolbar.button.togshowdesk.commands:	ToggleCmd {ShowDesktop Matches (Title!=conky)} {DeIconify all}
session.screen0.toolbar.button.togshowdesk.font:	sans-10-bold
session.screen0.toolbar.button.togshowdesk.label:	\342\207\205
session.screen0.toolbar.height:	16
session.screen0.toolbar.layer:	AboveDock
session.screen0.toolbar.maxOver:	false
session.screen0.toolbar.onTop:	false
session.screen0.toolbar.onhead:	0
session.screen0.toolbar.placement:	BottomCenter
session.screen0.toolbar.tools:	button.homenu, workspacename, prevworkspace, nextworkspace, button.togshowdesk, iconbar, systemtray, prevwindow, nextwindow, clock
session.screen0.toolbar.visible:	true
session.screen0.toolbar.widthPercent:	100
session.screen0.tooltipDelay:	500
session.screen0.userFollowModel:	Follow
session.screen0.window.focus.alpha:	180
session.screen0.window.unfocus.alpha:	180
session.screen0.windowMenu:
session.screen0.windowPlacement:	RowSmartPlacement
session.screen0.workspaceNames:	ws: A, ws: B, ws3, Workspace Delta, Workspace Epsilon
session.screen0.workspaces:	5
session.screen0.workspacewarping:	true
session.slitlistFile:	~/.fluxbox/slitlist
session.styleOverlay:	~/.fluxbox/overlay
session.tabPadding:	0
session.tabs:	true
session.tabsAttachArea:	Window
session.titlebar.left:	Stick
session.titlebar.right:	Minimize Maximize Close
session.updateDelayTime:	5
session.useMod1:	true
